68
17
8 8 8 8 8 8 8 8 8 8 8 8 8 8 8 8 8 8 8 8 8 8 8 8 8 8 8 8 8 8 8 8 8 8 8 8 8 8 8 8 8 8 8 8 8 8 8 8 8 8 8 8 8 8 8 8 8 8 8 8 8 8 8 8 8 8 8 7
1 9 0 0 0 0 0 0 0 0 0 0 0 0 0 0 0 0 0 0 0 0 0 0 0 0 0 0 0 0 0 0 0 0 0 0 0 0 0 0 0 0 0 0 0 0 0 0 0 0 0 0 0 0 0 0 0 0 0 0 0 0 0 0 0 0 30 1
1 9 0 0 0 0 0 0 0 7 7 7 7 7 7 0 0 0 0 0 0 0 0 0 0 0 0 0 0 0 0 0 0 0 0 0 0 0 0 0 0 0 0 0 0 0 0 0 0 0 0 0 0 0 0 0 0 0 0 0 0 0 0 0 0 0 10 1
1 9 0 0 0 0 0 0 0 0 8 8 8 8 0 0 0 0 0 0 0 0 0 0 0 0 0 0 0 0 0 0 0 0 0 0 0 0 0 0 0 0 0 0 0 0 0 0 0 0 0 0 0 0 0 0 0 0 0 0 0 0 0 0 0 0 0 1
1 9 0 0 0 0 0 0 0 0 8 8 8 8 0 0 0 0 0 0 0 0 0 0 0 7 7 7 0 0 0 0 0 0 0 0 0 0 0 0 0 0 0 0 0 0 0 0 0 0 0 0 0 0 0 0 0 0 0 0 0 0 0 0 0 0 0 1
1 9 0 0 0 0 0 0 0 0 8 8 8 8 0 0 0 0 0 0 0 0 0 0 0 0 8 0 0 0 0 0 0 0 0 0 0 0 0 0 0 0 0 0 0 0 0 0 0 0 0 0 0 0 0 0 0 0 0 0 0 0 0 0 0 0 0 1
1 9 0 0 0 0 0 0 0 0 7 7 7 7 7 7 7 0 0 0 4 0 0 0 0 0 8 0 0 0 0 0 0 0 0 0 0 0 0 0 0 0 0 0 0 0 0 0 0 0 0 0 0 0 0 0 0 0 0 0 0 0 0 0 0 0 0 1
1 9 0 0 0 0 0 0 0 0 0 8 8 8 8 8 0 0 0 0 7 7 7 7 7 0 8 0 0 0 7 7 7 0 0 0 0 0 0 0 0 0 0 0 0 0 0 0 0 0 0 0 0 0 0 0 0 0 0 0 0 0 0 0 0 0 0 1
1 9 0 0 0 0 0 0 0 0 0 8 8 8 8 8 0 0 0 0 0 8 8 8 0 0 8 0 0 0 0 8 0 0 0 0 0 0 0 0 0 0 0 7 7 7 7 7 7 7 0 0 0 0 0 0 0 0 0 0 0 0 0 0 0 0 0 1
1 9 0 0 0 0 0 0 0 0 0 8 8 8 8 8 0 0 0 0 0 8 8 8 0 0 8 0 0 0 0 8 0 0 0 4 0 0 0 0 0 0 0 0 8 8 8 8 8 0 0 0 0 0 0 0 0 0 0 0 0 0 0 0 0 0 0 1
1 9 0 0 0 0 0 0 0 0 0 8 8 8 8 8 0 0 0 0 0 8 8 8 0 0 8 0 0 0 0 8 0 0 7 7 7 7 7 7 0 0 0 0 8 8 8 8 8 0 0 0 0 0 0 0 0 0 0 0 0 0 0 0 0 0 0 1
1 9 0 0 0 0 0 0 0 0 0 8 8 8 8 8 0 0 0 0 0 8 8 8 0 0 8 0 0 0 0 8 0 0 0 8 8 8 8 0 0 0 0 0 8 8 8 8 8 0 0 0 7 7 7 7 7 0 0 0 0 0 0 0 0 0 0 1
1 9 0 0 0 0 0 0 0 0 0 8 8 8 8 8 0 0 0 0 0 8 8 8 0 0 8 0 0 0 0 8 0 0 0 8 8 8 8 0 0 0 0 0 8 8 8 8 8 0 0 0 0 8 8 8 0 0 0 0 0 0 0 0 0 0 0 1
1 9 40 0 0 0 0 0 0 0 0 8 8 8 8 8 0 0 0 0 0 8 8 8 0 0 8 0 0 0 0 8 0 0 0 8 8 8 8 0 0 0 0 0 8 8 8 8 8 0 0 0 0 8 8 8 0 0 0 0 0 0 0 0 0 0 0 1
7 7 7 7 7 7 7 0 0 0 0 8 8 8 8 8 0 0 0 0 0 8 8 8 0 0 8 0 0 0 0 8 0 0 0 8 8 8 8 0 0 0 0 0 8 8 8 8 8 0 0 0 0 8 8 8 0 0 0 7 7 7 7 7 7 7 7 7
7 7 7 7 7 7 7 0 0 0 0 8 8 8 8 8 0 0 0 0 0 8 8 8 0 0 8 0 0 0 0 8 0 0 0 8 8 8 8 0 0 0 0 0 8 8 8 8 8 0 0 0 0 8 8 8 0 0 0 7 7 7 7 7 7 7 7 7
7 7 7 7 7 7 7 7 7 7 7 7 7 7 7 7 7 7 7 7 7 7 7 7 7 7 7 7 7 7 7 7 7 7 7 7 7 7 7 7 7 7 7 7 7 7 7 7 7 7 7 7 7 7 7 7 7 7 7 7 7 7 7 7 7 7 7 7
